########################
#**********************#
#***A************#*****#
#*****####*******#*****#
#****************#*****#
#**********************#
#****#****#****###*****#
#*********#************#
#**********************#
########################
